+---+---+---+---+---+---+---+
| h       e               h |
+   +---+   +   +   +---+   +
| n                       h |
+---+---+---+---+---+---+---+
