+---+---+---+---+---+---+---+---+
| h             | h             |
+   +---+   +---+   +---+   +---+
|   |           |   |           |
+   +   +   +   +   +   +   +   +
|       | e |           | e |   |
+   +   +   +   +   +   +   +   +
|   |           |   |           |
+   +---+   +---+   +---+   +---+
| n             |               |
+---+---+---+---+---+---+---+---+
