+---+---+---+---+---+---+---+
| h                       h |
+   +---+---+   +---+---+   +
|   |                   |   |
+   +   +---+   +---+   +   +
|       | e   e   e |       |
+   +   +---+   +---+   +   +
|   |       |   |       |   |
+   +---+   +   +   +---+   +
| n                       h |
+---+---+---+---+---+---+---+
