+---+---+---+---+---+---+---+
| h       e   e           h |
+   +---+   +   +   +---+   +
| n                       h |
+---+---+---+---+---+---+---+
